11111111111111111
10E000000001C1001
1000C000000101001
10C000C0000000001
1P000001000000001
10000000000000001
10000000000000001
10000000000000001
10000000000000001
11111111111111111
