11111111111
1111111111
0000000000
11111111111
1111111111
0000000000
11111111111
1111111111
0000000000
11111111111
1111111111
0000000000
11111111111
1111111111
0000000000
11111111111
