
11111111111
11111111111
00000000011
